~	〜
/	・
,	、
.	。
[	「
]	」
-	ー
:	ー
la	ぁ
a	あ
li	ぃ
lyi	ぃ
i	い
ye	いぇ
yw	いぇい
yd	いぇん
lu	ぅ
u	う
vu	ゔ
va	ゔぁ
vq	ゔぁい
vn	ゔぁん
vz	ゔぁん
wi	うぃ
vi	ゔぃ
wk	うぃん
vk	ゔぃん
vh	ゔー
we	うぇ
ve	ゔぇ
ww	うぇい
vw	ゔぇい
wd	うぇん
vd	ゔぇん
who	うぉ
wso	うぉ
vo	ゔぉ
vp	ゔぉう
wp	うぉー
wl	うぉん
vl	ゔぉん
vyu	ゔゅ
vv	ゔゅー
vj	ゔん
le	ぇ
lye	ぇ
e	え
lo	ぉ
o	お
lka	ヵ
ka	か
ga	が
kq	かい
gq	がい
km	かも
kr	から
gr	がら
kn	かん
kz	かん
gn	がん
gz	がん
kf	き
gi	ぎ
kge	きぇ
gye	ぎぇ
kgw	きぇい
gyw	ぎぇい
kgd	きぇん
gyd	ぎぇん
kga	きゃ
gya	ぎゃ
kgq	きゃい
gyq	ぎゃい
kgn	きゃん
kgz	きゃん
gyn	ぎゃん
gyz	ぎゃん
kgu	きゅ
gyu	ぎゅ
kgh	きゅう
kv	きゅう
gv	ぎゅう
gyh	ぎゅう
kgj	きゅん
gyj	ぎゅん
kgo	きょ
gyo	ぎょ
kgp	きょう
kx	きょう
gx	ぎょう
gyp	ぎょう
kgl	きょん
gyl	ぎょん
kk	きん
gk	ぎん
ku	く
gu	ぐ
kh	くう
gh	ぐう
kj	くん
gj	ぐん
lke	ヶ
ke	け
ge	げ
kw	けい
gw	げい
kd	けん
gd	げん
ko	こ
go	ご
kp	こう
gp	ごう
kt	こと
gt	ごと
kl	こん
gl	ごん
sa	さ
zc	ざ
sf	さい
zv	ざい
zr	ざる
sn	さん
zn	ざん
zz	ざん
si	し
xi	し
ji	じ
zi	じ
xe	しぇ
je	じぇ
xw	しぇい
jw	じぇい
xd	しぇん
jd	じぇん
st	した
xa	しゃ
ja	じゃ
xq	しゃい
jq	じゃい
xn	しゃん
xz	しゃん
jz	じゃん
xu	しゅ
jf	じゅ
sv	しゅう
xh	しゅう
jh	じゅう
xj	しゅん
jj	じゅん
xo	しょ
jo	じょ
sx	しょう
xp	しょう
jp	じょう
xl	しょん
jl	じょん
sk	しん
xk	しん
jk	じん
zk	じん
su	す
zu	ず
syi	すぃ
syk	すぃん
sh	すう
zh	ずう
sr	する
sj	すん
zj	ずん
se	せ
zf	ぜ
ss	せい
zx	ぜい
sd	せん
zd	ぜん
so	そ
zo	ぞ
sp	そう
zp	ぞう
sl	そん
zl	ぞん
ta	た
da	だ
tq	たい
dq	だい
tt	たち
dt	だち
tb	たび
tm	ため
tr	たら
tn	たん
dn	だん
dz	だん
ci	ち
ti	ち
di	ぢ
cf	ちぇ
dge	ぢぇ
cw	ちぇい
cd	ちぇん
ca	ちゃ
dga	ぢゃ
cq	ちゃい
dgq	ぢゃい
cn	ちゃん
cz	ちゃん
dgz	ぢゃん
cu	ちゅ
dgu	ぢゅ
ch	ちゅう
dv	ぢゅう
cj	ちゅん
dgj	ぢゅん
co	ちょ
dgo	ぢょ
cp	ちょう
dx	ぢょう
cl	ちょん
dgl	ぢょん
ck	ちん
tk	ちん
dk	ぢん
;	っ
ltu	っ
tsu	つ
tu	つ
du	づ
tsa	つぁ
tsq	つぁい
tsz	つぁん
tsi	つぃ
tsk	つぃん
th	つう
tsh	つう
dh	づう
tse	つぇ
tsd	つぇん
tso	つぉ
tsl	つぉん
tj	つん
tsj	つん
dj	づん
te	て
df	で
dr	である
tgi	てぃ
tw	てい
dci	でぃ
dgi	でぃ
dw	でい
tgk	てぃん
dck	でぃん
ds	です
dm	でも
tya	てゃ
tyq	てゃい
tyz	てゃん
tyu	てゅ
dyu	でゅ
tgh	てゅー
tyh	てゅー
dgh	でゅー
tyj	てゅん
td	てん
dd	でん
to	と
do	ど
tgu	とぅ
tp	とう
dcu	どぅ
dp	どう
tgp	とぅー
dch	どぅー
tgj	とぅん
dcj	どぅん
tst	として
tl	とん
dl	どん
na	な
nq	ない
nr	なる
nz	なん
ni	に
nge	にぇ
ngw	にぇい
ngd	にぇん
nt	にち
nga	にゃ
ngq	にゃい
ngn	にゃん
ngz	にゃん
ngu	にゅ
ngh	にゅう
nv	にゅう
ngj	にゅん
ngo	にょ
ngp	にょう
nx	にょう
ngl	にょん
nk	にん
nf	ぬ
nh	ぬう
nj	ぬん
ne	ね
nw	ねい
nb	ねば
nd	ねん
no	の
np	のう
nl	のん
ha	は
ba	ば
pa	ぱ
hq	はい
bq	ばい
pq	ぱい
hr	はら
hz	はん
bn	ばん
bz	ばん
pn	ぱん
pz	ぱん
hi	ひ
bi	び
pi	ぴ
hge	ひぇ
hye	ひぇ
bye	びぇ
pge	ぴぇ
hgw	ひぇい
byw	びぇい
pgw	ぴぇい
hgd	ひぇん
hyd	ひぇん
byd	びぇん
pgd	ぴぇん
ht	ひと
bt	びと
hga	ひゃ
hya	ひゃ
bya	びゃ
pga	ぴゃ
hgq	ひゃい
hyq	ひゃい
byq	びゃい
pgq	ぴゃい
hgn	ひゃん
hgz	ひゃん
hyz	ひゃん
byn	びゃん
byz	びゃん
pgn	ぴゃん
pgz	ぴゃん
hgu	ひゅ
hyu	ひゅ
byu	びゅ
pgu	ぴゅ
pyu	ぴゅ
hgh	ひゅう
hv	ひゅう
hyh	ひゅう
bv	びゅう
byh	びゅう
pgh	ぴゅう
pv	ぴゅう
hgj	ひゅん
hyj	ひゅん
byj	びゅん
pgj	ぴゅん
hgo	ひょ
hyo	ひょ
byo	びょ
pgo	ぴょ
hgp	ひょう
hx	ひょう
hyp	ひょう
bx	びょう
byp	びょう
pgp	ぴょう
px	ぴょう
hgl	ひょん
hyl	ひょん
byl	びょん
pgl	ぴょん
hk	ひん
bk	びん
pk	ぴん
fu	ふ
hf	ふ
bf	ぶ
pu	ぷ
fa	ふぁ
fq	ふぁい
fn	ふぁん
fz	ふぁん
fi	ふぃ
fk	ふぃん
fh	ふう
hh	ふう
bh	ぶう
ph	ぷう
fe	ふぇ
fw	ふぇい
fd	ふぇん
fo	ふぉ
fp	ふぉー
fl	ふぉん
fyu	ふゅ
fv	ふゅー
fyh	ふゅー
fyj	ふゅん
fj	ふん
hj	ふん
bj	ぶん
pj	ぷん
he	へ
be	べ
pe	ぺ
hw	へい
bw	べい
pw	ぺい
hd	へん
bd	べん
pd	ぺん
ho	ほ
bo	ぼ
po	ぽ
hp	ほう
bp	ぼう
pp	ぽう
hl	ほん
bl	ぼん
pf	ぽん
ma	ま
mq	まい
ms	ます
mt	また
mr	まる
mz	まん
mi	み
mge	みぇ
mgw	みぇい
mgd	みぇん
mga	みゃ
mgq	みゃい
mgn	みゃん
mgz	みゃん
mgu	みゅ
mgh	みゅう
mv	みゅう
mgj	みゅん
mgo	みょ
mgp	みょう
mx	みょう
mgl	みょん
mk	みん
mf	む
mh	むう
mj	むん
me	め
mw	めい
md	めん
mo	も
mp	もう
mn	もの
ml	もん
lya	ゃ
ya	や
yq	やい
yz	やん
lyu	ゅ
yf	ゆ
yh	ゆう
yj	ゆん
lyo	ょ
yo	よ
yp	よう
yr	よる
yl	よん
ra	ら
rq	らい
rr	られ
rn	らん
ri	り
rye	りぇ
ryw	りぇい
ryd	りぇん
rya	りゃ
ryq	りゃい
ryz	りゃん
ryu	りゅ
rv	りゅう
ryh	りゅう
ryj	りゅん
ryo	りょ
rx	りょう
ryp	りょう
ryl	りょん
rk	りん
ru	る
rh	るう
rj	るん
re	れ
rw	れい
rd	れん
ro	ろ
rp	ろう
rl	ろん
lwa	ゎ
wa	わ
wf	わい
wt	わた
wr	われ
wn	わん
whi	ゐ
whe	ゑ
wo	を
nn	ん
q	ん
bu	ぶ
